##@@##@#@##@@#####@JJKKJ+++++++KJKJKJJKJKJ+++++++JKJKJJKJJKKJ
#     W     W    XXXLLLL+++:+++LLLLOLOLLOL+++:+++LLLLLLLLVLLJ
#   Q  %$ & $ %  Q XLJKL+++++++L|L|L|L|L|L+++++++LLLLLKLLLLLJ
$ & %   $%  %&    XXLLKL+++:+++++++++++++++++:+++LLLKLVLOLLLK
$% $ & &  & $ Q    XXXLL+++++++++++++++++++++++++LLLOLKLLLLKJ
$%$ &$  &% %   Q    XLLL+++++++++++++++++++++++++LLLLVLLLVLLJ
$ $% %$ $  $    QQ XXLJL++++++:+++++:+++++:++++++LLLOLLKLLLLJ
#   & % &%        XXLLLL+++++++++++++++++++++++++LLLLLKKLVLLJ
#    %  &  W       XXLLL++++++++++++D++++++++++++LLLLKVLVLLKJ
#     $        W   XXLJLLLLLLLLLOLLLOLOLLLLVVLJLLLLLLOLLVLLLK
#   Q     Q       XXLLLVLLLLVLLLLLLOLLLLLLVLLLLLLLLKKLLLOLLLK
#      Q         XXLVLLJLLKKLOLLOLOLLOLLVLLLJLLLVVLLLLVLLLLLJ
#   W        XXXXLLLLLOLLLJLLLLVLVLLOLLLLOOLLJLVLLKLLLLOLLLKJ
#      Q    XXXLLLVOLLLKJLLLOLLOLLLVLLLVLLLLLLOLLVLOLLLLLLLKJ
@  W     XXXXLLLLVLLOLLLLLLLOLLLJLLKLLLLLVLJLLLOLLLLVLLOLLLLJ
@     XXXLLLLLVLVLLJLLLOLLLOLLLVLLLVLLLJLLLLLLKLLLKLLLLLLLLLK
#  XXXLLLOLLVLLLOLLLLOLLLVVLLLJLLLJLLLKLLLLLLLLKLLLLVLOLLLLLJ
KXXXLLLLVVLLLJLLLLVLLJLLVLLJLLOLLLLOLLLVLLLKLLLVLLLVVLLLLLLKJ
JLVLLKLVLLOLOLLLLJLLLLLKLOLLLLOLLLLLLOLLLOLLLLOLJLLLOLLJLLLLK
JKLLLVLLLOLLKLJLOLLLLVLLLOLLOLLLKLLKLLLLOLLLOLLVLLOLLLJJLLLLJ
KLKLLLKLLLOLLVLLLJLOLLLJLLLLKLLLLVLLLLKKLLLLJLLLVVLLOLLLLLKKJ
JLLLKLJLVVLLJLLOLLLOLKLLVLOLLLVLLLOLLLLLKLLLLLLJOLLJLLLLKLLKK
KLKKLKLLKLLVLLLKLLVVLLLVLLVLLOLLVLLVLLKLVLLLOLVLLJJVLLJLLKLLK
KJLKLLLKKLKLLLLVLLLVLKKLJLKLJLKLLLJJLLLKLLKLLJKKLJLLLLLJKLLKJ
JJKJKKJJKJJKKJJKJKKJJKJJKJJKJKKJJKKJKJKJKJKJJKJKJKKJKJJJJKKJK
*...........................................................*
,ççççççççççççççççççççççççççççççççççççççççççççççççççççççççççç-
,ççççççççççççççççççççççççççççççççççççççççççççççççççççççççççç-
,ççççççççççççççççççççççççççççççççççççççççççççççççççççççççççç-
,ççççççççççççççççççççççççççççççççççççççççççççççççççççççççççç-
,ççççççççççççççççççççççççççççççççççççççççççççççççççççççççççç-
*___________________________________________________________*