#############################################################
#                                                           #
#                                                           #
$                                                           #
$                                                           #
$                                                           #
$                                                           #
#                                                           #
#                                                           #
#                                                           #
#                                                           #
#                                                           #
#                                                           #
#                                                           #
#                                                           #
#                                                           #
#                                                           #
#                                                           #
#                                                           #
#                                                           #
#                                                           #
#                                                           #
#                                                           #
#                                                           #
#############################################################