BBBBBBBBBBBBBBBBBBBBBBBBBBBBBBBBBBBBBBBBBBBBBBBBBBBBBBBBBBBBB
BBBBBBBBBBBBBBBBBBBBBBBBBBBBBBBBBBBBBBBBBBBBBBBBBBBBBBBBBBBBB
BBBBBBBBBBBBBBBBBBBBBBBBBBBBBBBBBBBBBBBBBBBBBBBBBBBBBBBBBBBBB
BBBBBBBBBBBBBBBBBBBBBBBBBBBBBBBBBBBBBBBBBBBBBBBBBBBBBBBBBBBBB
BBBBBBBBBBBBBBBBBBBBBBBBBBBBBBBBBBBBBBBBBBBBBBBBBBBBBBBBBBBBB
BBBBBBBBBBBBBBBBBBBBBBBBBBBBBBBBBBBBBBBBBBBBBBBBBBBBBBBBBBBBB
BBBBBBBBBBBBBBBBBBBBBBBBBBBBBBBBBBBBBBBBBBBBBBBBBBBBBBBBBBBBB
BBBBBBBBBBBBBBBBBBBBBBBBBBBBBBBBBBBBBBBBBBBBBBBBBBBBBBBBBBBBB
BBBBBBBBBBBBBBBBBBBBBBBBBBBBBBBBBBBBBBBBBBBBBBBBBBBBBBBBBBBBB
BBBBBBBBBBBBBBBBBBBBBBBBBBBBBBBBBBBBBBBBBBBBBBBBBBBBBBBBBBBBB
BBBBBBBBBBBBBBBBBBBBBBBBBBBBBBBBBBBBBBBBBBBBBBBBBBBBBBBBBBBBB
BBBBBBBBBBBBBBBBBBBBBBBBBBBBBBBBBBBBBBBBBBBBBBBBBBBBBBBBBBBBB
BBBBBBBBBBBBBBBBBBBBBBBBBBBBBBB<<<<<<<><<<<<<<<<<<<<<<<BBBBBB
BBBBBBBBBBBBBBBBBBBBBBBBBBBBBBB<£££§£££££»££££££££££££<BBBBBB
BBBBBBBBBBBB<<<<<<<><~<<<<><~<<<££££££££££££<<<<><<<<£<BBBBBB
BBBBBBBBBBBB<»£££££££££§££££££»££££££££££££S<BBBBBBB<£<BBBBBB
BBBBBBBBBBBB<£££££££££££££££££££££££££££££££<BBBBBBB<£~BBBBBB
BBBBBBBBBBBB>£££££££££££»££££££££££££££££££»<BBBBBBB<£<BBBBBB
BBBBBBBBBBBB<£££££££££<<<<<~<<<<££££££££££££~BBBBBBB>£<BBBBBB
BBBBBBBBBBBB<£££££££££<BBBBBBBB<££££££££££££<BBBBBBB<£<BBBBBB
BBBBBBBBBBBB<»£££££££»<BBBBBBBB<»£££££££££££<BBBBBBB<£<BBBBBB
BBBBBBBBBBBB~£££££££££<BBBBBBBB>££££££££££££<<<<<<<<<£~BBBBBB
BBBBBBBBBBBB<£££££££££>BBBBBBBB<£££££££££££££«££C£££££<BBBBBB
BBBBBBBBBBBB<»£££££££»<BBBBBBBB~££§£££££»££££«££»£<<<<<BBBBBB
BBBBBBBBBBBB<<<<<D<<<<<BBBBBBBB<<<<<<><<<<~<<<<<<<<BBBBBBBBBB