BBBBBBBBBBBBBBBBBBBBBBBBBBBBBBBBBBBBBBBBBBBBBBBBBBBBBBBBBBBBB
BBBBBBBBBBBBBBBBBBBBBBBBBBBBBBBBBBBBBBBBBBBBBBBBBBBBBBBBBBBBB
BBBBBBBBBBBBBBBBBBBBBBBBBBBBBBBBBBBBBBBBBBBBBBBBBBBBBBBBBBBBB
BBBBBBBBBBBBBBBBBBBBBBBBBBBBBBBBBBBBBBBBBBBBBBBBBBBBBBBBBBBBB
BBBBBBBBBBBBBBBBBBBBBBBBBBBBBBB<<<<<<<><<<<<<<<<<<<<<<<BBBBBB
BBBBBBBBBBBBBBBBBBBBBBBBBBBBBBB<£££§£££££»££££££££££££<BBBBBB
BBBBBBBBBBBB<<<<<<<><~<<<<><~<<<££££££££££££<<<<><<<<£<BBBBBB
BBBBBBBBBBBB<»£££££££££§££££££»£££££££££££££SBBBBBBB<£<BBBBBB
BBBBBBBBBBBB<£££££££££££££££££££££££££££££££<BBBBBBB<£~BBBBBB
BBBBBBBBBBBB>£££££££££££»££££££££££££££££££»<BBBBBBB<£<BBBBBB
BBBBBBBBBBBB<£££££££££<<<<<~<<<<££££££££££££~BBBBBBB>£<BBBBBB
BBBBBBBBBBBB<£££££££££<BBBBBBBB<££££££££££££<BBBBBBB<£<BBBBBB
BBBBBBBBBBBB<»£££££££»<BBBBBBBB<»£££££££££££<BBBBBBB<£<BBBBBB
BBBBBBBBBBBB~£££££££££<BBBBBBBB>££££££££££££<<<<<<<<<£~BBBBBB
BBBBBBBBBBBB<£££££££££>BBBBBBBB<££££££££££££££££C£££££<BBBBBB
BBBBBBBBBBBB<»£££££££»<BBBBBBBB~££§£££££»£££££££»£<<<<<BBBBBB
BBBBBBBBBBBB<<<<<D<<<<<BBBBBBBB<<<<<<><<<<~<<<<<<<<BBBBBBBBBB
BBBBBBBBBBBBBBBBBBBBBBBBBBBBBBBBBBBBBBBBBBBBBBBBBBBBBBBBBBBBB
BBBBBBBBBBBBBBBBBBBBBBBBBBBBBBBBBBBBBBBBBBBBBBBBBBBBBBBBBBBBB
BBBBBBBBBBBBBBBBBBBBBBBBBBBBBBBBBBBBBBBBBBBBBBBBBBBBBBBBBBBBB
BBBBBBBBBBBBBBBBBBBBBBBBBBBBBBBBBBBBBBBBBBBBBBBBBBBBBBBBBBBBB
BBBBBBBBBBBBBBBBBBBBBBBBBBBBBBBBBBBBBBBBBBBBBBBBBBBBBBBBBBBBB
BBBBBBBBBBBBBBBBBBBBBBBBBBBBBBBBBBBBBBBBBBBBBBBBBBBBBBBBBBBBB
BBBBBBBBBBBBBBBBBBBBBBBBBBBBBBBBBBBBBBBBBBBBBBBBBBBBBBBBBBBBB
BBBBBBBBBBBBBBBBBBBBBBBBBBBBBBBBBBBBBBBBBBBBBBBBBBBBBBBBBBBBB
*...........................................................*
,ççççççççççççççççççççççççççççççççççççççççççççççççççççççççççç-
,ççççççççççççççççççççççççççççççççççççççççççççççççççççççççççç-
,ççççççççççççççççççççççççççççççççççççççççççççççççççççççççççç-
,ççççççççççççççççççççççççççççççççççççççççççççççççççççççççççç-
,ççççççççççççççççççççççççççççççççççççççççççççççççççççççççççç-
*___________________________________________________________*
