BBBBBBBBBBBBBBBBBBBBBBBBBBBBBBBBBBBBBBBBBBBBBBBBBBBBBBBBBBBBB
BBBBBBBBBBBBBBBBBBBBBBBBBBBBBBBBBBBBBBBBBBBBBBBBBBBBBBBBBBBBB
BBBBBBBBBBBBBBBBBBBBBBBBBBBBBBBBBBBBBBBBBBBBBBBBBBBBBBBBBBBBB
BBBBBBBBBBBBBBBBBBBBBBBB<<<<<<<<><<<<<<<><<<<<~<<<<BBBBBBBBBB
BBBBBBBBBBBBBBBBBBBBBBBB~££££££§£££££££»£££££££££»~BBBBBBBBBB
BBBBBBBBBBBBBBBBBBBBBBBB<£££££££££££££££££££££££££<BBBBBBBBBB
BBBBBBBBBBBBBBBBBBBBBBBB<£££££££££££££££££££££££££SBBBBBBBBBB
BBBBBBBBBBBBBBBBBBBBBBBB~£££££££££££££££££££££££££>BBBBBBBBBB
BBBBBBBBBBBBBBBBBBBBBBBB<£££££££££££££££££££££££££<BBBBBBBBBB
BBBBBBBBBBBBBBBBBBBBBBBB<»£££££££££££££££££££§££££<BBBBBBBBBB
BBBBB<<><<<<~<<<<BBBBBBB<<<<<~<<><<<££££<<<~<<<<><<BBBBBBBBBB
BBBBB<»££££££££C<BBBBBBBBBBBBBBBBBB<££££<BBBBBBBBBBBBBBBBBBBB
BBBBB<££££££££££>BBBBBBBBBBBBBB<<<<<££££<<<<<BBBBBBBBBBBBBBBB
BBBBB~££££££££££<BBBBBBBBBBBBBB<»££§£££££»££<BBBBBBBBBBBBBBBB
BBBBB<§£££££££££<<<><~<<<<><~<<<££££££££££££<BBBBBBBBBBBBBBBB
BBBBB<<££££££££££££££££§££££££»£££££££££££££SBBBBBBBBBBBBBBBB
BBBBBB<<><~<<£££££££££££££££££££££££££££££££<BBBBBBBBBBBBBBBB
BBBBBBBBBBBB>»££££££££££»££££££££££££££££££»<BBBBBBBBBBBBBBBB
BBBBBBBBBBBB<<~<<<<><<<~<<<~<<<<<<<<<><<<~>>~BBBBBBBBBBBBBBBB
BBBBBBBBBBBBBBBBBBBBBBBBBBBBBBBBBBBBBBBBBBBBBBBBBBBBBBBBBBBBB
BBBBBBBBBBBBBBBBBBBBBBBBBBBBBBBBBBBBBBBBBBBBBBBBBBBBBBBBBBBBB
BBBBBBBBBBBBBBBBBBBBBBBBBBBBBBBBBBBBBBBBBBBBBBBBBBBBBBBBBBBBB
BBBBBBBBBBBBBBBBBBBBBBBBBBBBBBBBBBBBBBBBBBBBBBBBBBBBBBBBBBBBB
BBBBBBBBBBBBBBBBBBBBBBBBBBBBBBBBBBBBBBBBBBBBBBBBBBBBBBBBBBBBB
BBBBBBBBBBBBBBBBBBBBBBBBBBBBBBBBBBBBBBBBBBBBBBBBBBBBBBBBBBBBB
*...........................................................*
,ççççççççççççççççççççççççççççççççççççççççççççççççççççççççççç-
,ççççççççççççççççççççççççççççççççççççççççççççççççççççççççççç-
,ççççççççççççççççççççççççççççççççççççççççççççççççççççççççççç-
,ççççççççççççççççççççççççççççççççççççççççççççççççççççççççççç-
,ççççççççççççççççççççççççççççççççççççççççççççççççççççççççççç-
*___________________________________________________________*